[
    [1, 1, 1, 1, 1, 1, 1, 1, 1, 1, 1, 1, 1, 1, 1, 1, 1, 1, 1, 1],
    [1, 0, 0, 0, 0, 0, 0, 0, 0, 0, 0, 0, 0, 0, 0, 0, 0, 0, 0, 1],
    [1, 0, 0, 0, 0, 0, 0, 0, 0, 0, 0, 0, 0, 0, 0, 0, 0, 0, 0, 1],
    [1, 0, 0, 0, 0, 0, 0, 0, 0, 0, 0, 0, 0, 0, 0, 0, 0, 0, 0, 1],
    [1, 0, 0, 0, 0, 0, 0, 0, 0, 0, 4, 0, 0, 0, 0, 0, 0, 6, 6, 1],
    [1, 0, 0, 0, 0, 0, 0, 0, 0, 3, 0, 3, 0, 0, 0, 0, 0, 2, 2, 1],
    [1, 0, 0, 0, 0, 0, 5, 0, 0, 4, 0, 4, 0, 0, 0, 0, 0, 1, 1, 1],
    [1, 0, 0, 0, 0, 2, 6, 6, 6, 6, 6, 6, 6, 6, 2, 0, 0, 1, 1, 1],
    [1, 0, 0, 0, 0, 1, 1, 1, 1, 1, 1, 1, 1, 1, 1, 0, 0, 1, 1, 1],
    [1, 0, 0, 7, 5, 1, 0, 0, 0, 0, 0, 0, 0, 0, 0, 0, 0, 1, 1, 1],
    [1, 0, 7, 0, 0, 1, 7, 7, 7, 7, 7, 7, 7, 7, 7, 7, 7, 1, 1, 1],
    [1, 5, 0, 7, 0, 1, 7, 7, 2, 2, 2, 2, 2, 2, 2, 2, 2, 1, 1, 1],
    [1, 0, 7, 0, 0, 1, 7, 7, 0, 0, 0, 0, 0, 0, 0, 0, 0, 0, 0, 1],
    [1, 0, 0, 7, 5, 1, 7, 7, 7, 7, 7, 7, 7, 7, 7, 7, 7, 0, 0, 1],
    [1, 0, 7, 0, 0, 1, 2, 2, 2, 2, 2, 2, 2, 2, 2, 2, 2, 0, 0, 1],
    [1, 5, 0, 7, 0, 1, 0, 0, 0, 0, 0, 0, 0, 0, 0, 0, 0, 0, 0, 1],
    [1, 0, 7, 0, 0, 1, 0, 0, 0, 0, 0, 0, 0, 0, 0, 0, 0, 0, 2, 1],
    [1, 0, 0, 7, 5, 1, 0, 8, 0, 0, 0, 0, 0, 0, 0, 0, 0, 2, 1, 1],
    [1, 6, 0, 0, 6, 1, 2, 2, 2, 6, 2, 6, 2, 6, 2, 6, 2, 1, 1, 1],
    [1, 1, 1, 1, 1, 1, 1, 1, 1, 1, 1, 1, 1, 1, 1, 1, 1, 1, 1, 1]
]